XXXXXXXXXXXXXXXXXXXXXXXXXXXXXXXX
X..............................X
X..............................X
X..............B...............X
X............XXAXX.............X
X............XAACX.............X
X............XXXXX.............X
X..............................X
XX............................XX
AA............................AA
XX............................XX
X..............................X
XP.............................X
X..............................X
XXXXXXXXXXXXXXXXXXXXXXXXXXXXXXXX
